NO ./textures/gradient2.xpm
SO ./textures/purplestone.xpm
WE ./textures/gradient3.xpm
EA ./textures/gradient4.xpm

F 48,48,48
C 0,0,0

		1111111111111111111111111
		1000000000110000001000001
		1011000001110000000000001
		1011000000000000000001001
111111111011000001110000000000001
100000000011000001110111110111111
11110111111111011100000010001
11110111111111011101010010001
11000000110101011100000010001
10000000000000001100000010001
10000000000000000101010010001
11000001110100011111011110N111
111101111110101111111010001
111111111111101111111111111