NO ./textures/gradient2.xpm
SO ./textures/purplestone.xpm
WE ./textures/gradient3.xpm
EA ./textures/gradient4.xpm

F 75,108,87
C 173,216, 230

111111111111111111111
110000000000000000011
100000000000000000001
100000000000000000001
100000000100000000001
100000001010000000001
100000000000000000001
10000N000000000000001
111111111111111111111
