F   23,30,35

NO ./textures/gradient2.xpm
C     20,44,54
SO ./textures/purplestone.xpm
WE ./textures/gradient3.xpm
EA ./textures/gradient4.xpm


11111111111111111111111111111111111111111    111111
1111000000000110000000000001 1               100011
 1010110000011100000100000111111111111       111111
111111111110010000W00000001100000011111111
1111111110110000011100000100000011
100000000011110001110111111111111
11110111111001011100000010001
11110111111111011101010010001
1100000011010101110000010001
1000000000000001100000010001
10000000000000001101010010001
1100000111010101111101111010111
11110111 1110101 10111101001
11111111 1111111 1111111111
111111111111